512 384 32 32 32 64 1 
544 384 32 32 194.255 50757.3 1 
544 384 32 32 32 64 1 
576 384 32 32 32 64 1 
608 384 32 32 32 64 1 
640 384 32 32 32 64 1 
640 352 32 32 194.255 50757.3 1 
640 352 32 32 194.255 50757.3 1 
640 352 32 32 194.255 50757.3 1 
640 352 32 32 32 64 1 
640 320 32 32 32 64 1 
640 288 32 32 32 64 1 
640 256 32 32 32 64 1 
640 224 32 32 32 64 1 
672 224 32 32 194.255 50757.3 1 
672 224 32 32 32 64 1 
704 224 32 32 32 64 1 
512 288 32 32 32 64 1 
480 288 32 32 32 64 1 
448 288 32 32 32 64 1 
416 224 32 32 96 64 1 
448 192 32 32 96 64 1 
416 192 32 32 96 64 1 
416 192 32 32 96 64 1 
640 96 32 32 32 32 1 
608 96 32 32 32 32 1 
576 96 32 32 32 32 1 
544 96 32 32 32 32 1 
480 384 32 32 32 64 1 
448 384 32 32 32 64 1 
384 384 32 32 32 64 1 
416 384 32 32 32 64 1 
352 384 32 32 32 64 1 
320 384 32 32 32 64 1 
256 384 32 32 32 64 1 
288 384 32 32 32 64 1 
224 384 32 32 32 64 1 
192 384 32 32 32 64 1 
160 384 32 32 32 64 1 
128 384 32 32 32 64 1 
96 384 32 32 32 64 1 
64 384 32 32 32 64 1 
32 384 32 32 32 64 1 
0 384 32 32 32 64 1 
