672 224 32 32 194.255 50757.3 1 
672 224 32 32 32 64 1 
704 224 32 32 32 64 1 
320 384 32 32 32 64 1 
256 384 32 32 32 64 1 
288 384 32 32 32 64 1 
224 384 32 32 32 64 1 
192 384 32 32 32 64 1 
160 384 32 32 32 64 1 
128 384 32 32 32 64 1 
96 384 32 32 32 64 1 
64 384 32 32 32 64 1 
32 384 32 32 32 64 1 
0 384 32 32 32 64 1 
736 192 32 32 64 32 1 
736 224 32 32 64 64 1 
736 256 32 32 64 96 1 
672 256 32 32 96 32 1 
704 256 32 32 32 96 1 
672 288 32 32 64 64 1 
672 320 32 32 64 64 1 
672 352 32 32 64 64 1 
672 384 32 32 64 64 1 
672 416 32 32 64 96 1 
640 416 32 32 32 96 1 
608 416 32 32 32 96 1 
576 416 32 32 32 96 1 
544 416 32 32 32 96 1 
512 416 32 32 32 96 1 
480 416 32 32 32 96 1 
448 416 32 32 32 96 1 
416 416 32 32 32 96 1 
384 416 32 32 32 96 1 
352 416 32 32 32 96 1 
320 416 32 32 32 96 1 
288 416 32 32 32 96 1 
256 416 32 32 32 96 1 
224 416 32 32 32 96 1 
192 416 32 32 32 96 1 
160 416 32 32 32 96 1 
128 416 32 32 32 96 1 
96 416 32 32 32 96 1 
64 416 32 32 32 96 1 
32 416 32 32 32 96 1 
0 416 32 32 32 96 1 
640 224 32 32 32 64 1 
640 256 32 32 32 64 1 
640 288 32 32 32 64 1 
640 320 32 32 32 64 1 
640 352 32 32 32 64 1 
640 384 32 32 32 64 1 
576 384 32 32 32 64 1 
608 384 32 32 32 64 1 
512 384 32 32 32 64 1 
544 384 32 32 32 64 1 
480 384 32 32 32 64 1 
448 384 32 32 32 64 1 
416 384 32 32 32 64 1 
384 384 32 32 32 64 1 
352 384 32 32 32 64 1 
