352 160 32 32 0 0 1 
384 160 32 32 0 0 1 
416 160 32 32 0 0 1 
480 160 32 32 0 0 1 
512 160 32 32 0 0 1 
544 160 32 32 0 0 1 
576 160 32 32 0 0 1 
640 160 32 32 0 0 1 
608 160 32 32 0 0 1 
288 224 32 32 0 0 1 
448 160 32 32 0 0 1 
288 192 32 32 0 0 1 
320 192 32 32 0 0 1 
352 192 32 32 0 0 1 
384 192 32 32 0 0 1 
416 192 32 32 0 0 1 
448 192 32 32 0 0 1 
480 192 32 32 0 0 1 
544 192 32 32 0 0 1 
512 192 32 32 0 0 1 
320 224 32 32 0 0 1 
352 224 32 32 0 0 1 
384 224 32 32 0 0 1 
416 224 32 32 0 0 1 
512 224 32 32 0 0 1 
544 224 32 32 0 0 1 
576 224 32 32 0 0 1 
576 192 32 32 0 0 1 
608 192 32 32 0 0 1 
640 192 32 32 0 0 1 
512 288 32 32 32 64 1 
512 320 32 32 32 64 1 
480 352 32 32 32 64 1 
480 320 32 32 32 64 1 
448 320 32 32 32 64 1 
416 320 32 32 32 64 1 
384 320 32 32 32 64 1 
384 352 32 32 32 64 1 
416 352 32 32 32 64 1 
448 352 32 32 32 64 1 
416 384 32 32 32 64 1 
352 288 32 32 0 32 1 
352 384 32 32 0 96 1 
384 416 32 32 0 96 1 
448 416 32 32 64 96 1 
512 384 32 32 64 96 1 
544 256 32 32 64 32 1 
384 384 32 32 96 0 1 
448 384 32 32 96 32 1 
512 352 32 32 96 32 1 
512 256 32 32 32 32 1 
480 288 32 32 32 0 1 
384 288 32 32 32 32 1 
416 288 32 32 32 32 1 
448 288 32 32 32 32 1 
544 288 32 32 64 64 1 
544 320 32 32 64 64 1 
480 384 32 32 32 96 1 
416 416 32 32 32 96 1 
352 320 32 32 0 64 1 
512 128 32 32 0 0 1 
576 128 32 32 0 0 1 
640 128 32 32 0 0 1 
608 128 32 32 0 0 1 
320 96 32 32 0 0 1 
288 96 32 32 0 0 1 
352 96 32 32 0 0 1 
384 128 32 32 0 0 1 
448 128 32 32 0 0 1 
544 128 32 32 0 0 1 
480 128 32 32 0 0 1 
288 128 32 32 0 0 1 
320 128 32 32 0 0 1 
352 128 32 32 0 0 1 
416 128 32 32 0 0 1 
384 96 32 32 0 0 1 
672 64 32 32 0 0 1 
640 96 32 32 0 0 1 
416 96 32 32 0 0 1 
576 96 32 32 0 0 1 
448 96 32 32 0 0 1 
480 96 32 32 0 0 1 
512 96 32 32 0 0 1 
512 64 32 32 0 0 1 
416 64 32 32 0 0 1 
640 64 32 32 0 0 1 
608 96 32 32 0 0 1 
544 96 32 32 0 0 1 
448 64 32 32 0 0 1 
352 64 32 32 0 0 1 
608 64 32 32 0 0 1 
576 64 32 32 0 0 1 
544 64 32 32 0 0 1 
480 64 32 32 0 0 1 
384 64 32 32 0 0 1 
288 64 32 32 0 0 1 
320 64 32 32 0 0 1 
352 32 32 32 0 0 1 
512 32 32 32 0 0 1 
608 32 32 32 0 0 1 
448 32 32 32 0 0 1 
256 32 32 32 0 0 1 
288 32 32 32 0 0 1 
320 32 32 32 0 0 1 
704 32 32 32 0 0 1 
672 32 32 32 0 0 1 
640 32 32 32 0 0 1 
416 32 32 32 0 0 1 
576 32 32 32 0 0 1 
544 32 32 32 0 0 1 
480 32 32 32 0 0 1 
384 32 32 32 0 0 1 
544 0 32 32 0 0 1 
384 0 32 32 0 0 1 
448 0 32 32 0 0 1 
576 0 32 32 0 0 1 
480 0 32 32 0 0 1 
320 0 32 32 0 0 1 
256 0 32 32 0 0 1 
288 0 32 32 0 0 1 
352 0 32 32 0 0 1 
416 0 32 32 0 0 1 
512 0 32 32 0 0 1 
608 0 32 32 0 0 1 
640 0 32 32 0 0 1 
672 0 32 32 0 0 1 
704 0 32 32 0 0 1 
448 224 32 32 0 0 1 
480 224 32 32 0 0 1 
480 256 32 32 0 0 1 
448 256 32 32 0 0 1 
416 256 32 32 0 0 1 
384 256 32 32 0 0 1 
352 256 32 32 0 0 1 
320 256 32 32 0 0 1 
288 256 32 32 0 0 1 
224 256 32 32 0 0 1 
256 256 32 32 0 0 1 
256 224 32 32 0 0 1 
224 224 32 32 0 0 1 
192 224 32 32 0 0 1 
192 256 32 32 0 0 1 
192 288 32 32 0 0 1 
544 352 32 32 64 96 1 
352 352 32 32 0 64 1 
352 416 32 32 0 0 1 
320 288 32 32 0 0 1 
320 320 32 32 0 0 1 
320 352 32 32 0 0 1 
320 384 32 32 0 0 1 
320 416 32 32 0 0 1 
320 448 32 32 0 0 1 
352 448 32 32 0 0 1 
384 448 32 32 0 0 1 
416 448 32 32 0 0 1 
448 448 32 32 0 0 1 
544 384 32 32 0 0 1 
576 352 32 32 0 0 1 
576 320 32 32 0 0 1 
576 288 32 32 0 0 1 
576 256 32 32 0 0 1 
608 224 32 32 0 0 1 
608 256 32 32 0 0 1 
608 288 32 32 0 0 1 
608 320 32 32 0 0 1 
608 352 32 32 0 0 1 
608 384 32 32 0 0 1 
576 384 32 32 0 0 1 
512 416 32 32 0 0 1 
480 416 32 32 0 0 1 
480 448 32 32 0 0 1 
512 448 32 32 0 0 1 
544 448 32 32 0 0 1 
544 416 32 32 0 0 1 
576 416 32 32 0 0 1 
608 416 32 32 0 0 1 
608 448 32 32 0 0 1 
576 448 32 32 0 0 1 
320 160 32 32 0 0 1 
288 160 32 32 0 0 1 
