672 224 32 32 194.255 50757.3 1 
672 224 32 32 32 64 1 
704 224 32 32 32 64 1 
320 384 32 32 32 64 1 
256 384 32 32 32 64 1 
288 384 32 32 32 64 1 
224 384 32 32 32 64 1 
192 384 32 32 32 64 1 
160 384 32 32 32 64 1 
128 384 32 32 32 64 1 
96 384 32 32 32 64 1 
64 384 32 32 32 64 1 
32 384 32 32 32 64 1 
736 256 32 32 64 96 1 
672 256 32 32 96 32 1 
704 256 32 32 32 96 1 
672 288 32 32 64 64 1 
672 320 32 32 64 64 1 
672 352 32 32 64 64 1 
672 384 32 32 64 64 1 
672 416 32 32 64 96 1 
640 416 32 32 32 96 1 
608 416 32 32 32 96 1 
576 416 32 32 32 96 1 
544 416 32 32 32 96 1 
512 416 32 32 32 96 1 
480 416 32 32 32 96 1 
448 416 32 32 32 96 1 
416 416 32 32 32 96 1 
384 416 32 32 32 96 1 
352 416 32 32 32 96 1 
320 416 32 32 32 96 1 
288 416 32 32 32 96 1 
256 416 32 32 32 96 1 
224 416 32 32 32 96 1 
192 416 32 32 32 96 1 
160 416 32 32 32 96 1 
128 416 32 32 32 96 1 
96 416 32 32 32 96 1 
64 416 32 32 32 96 1 
32 416 32 32 32 96 1 
640 224 32 32 32 64 1 
640 256 32 32 32 64 1 
640 288 32 32 32 64 1 
640 320 32 32 32 64 1 
640 352 32 32 32 64 1 
640 384 32 32 32 64 1 
576 384 32 32 32 64 1 
608 384 32 32 32 64 1 
512 384 32 32 32 64 1 
544 384 32 32 32 64 1 
480 384 32 32 32 64 1 
448 384 32 32 32 64 1 
416 384 32 32 32 64 1 
384 384 32 32 32 64 1 
352 384 32 32 32 64 1 
672 192 32 32 32 64 1 
704 192 32 32 32 64 1 
704 160 32 32 32 64 1 
736 160 32 32 32 64 1 
736 128 32 32 32 64 1 
768 128 32 32 32 64 1 
768 128 32 32 32 64 1 
768 160 32 32 32 64 1 
736 224 32 32 64 64 1 
736 192 32 32 96 32 1 
768 192 32 32 32 96 1 
800 192 32 32 32 96 1 
832 192 32 32 32 96 1 
864 192 32 32 32 96 1 
32 352 32 32 32 64 1 
96 352 32 32 32 64 1 
64 352 32 32 32 64 1 
128 352 32 32 32 64 1 
160 352 32 32 32 64 1 
192 352 32 32 32 64 1 
224 352 32 32 32 64 1 
256 352 32 32 32 64 1 
288 352 32 32 32 64 1 
320 352 32 32 32 64 1 
352 352 32 32 32 64 1 
384 352 32 32 32 64 1 
384 352 32 32 32 64 1 
416 352 32 32 32 64 1 
448 352 32 32 32 64 1 
480 352 32 32 32 64 1 
512 352 32 32 32 64 1 
544 352 32 32 32 64 1 
576 352 32 32 32 64 1 
608 352 32 32 32 64 1 
608 320 32 32 32 64 1 
608 288 32 32 32 64 1 
608 256 32 32 32 64 1 
608 224 32 32 32 64 1 
576 192 32 32 0 32 1 
608 192 32 32 32 32 1 
640 192 32 32 32 0 1 
672 160 32 32 32 0 1 
704 128 32 32 32 0 1 
640 160 32 32 0 32 1 
672 128 32 32 0 32 1 
576 320 32 32 32 0 1 
544 320 32 32 32 32 1 
512 320 32 32 32 32 1 
480 320 32 32 32 32 1 
448 320 32 32 32 32 1 
416 320 32 32 32 32 1 
384 320 32 32 32 32 1 
352 320 32 32 32 32 1 
320 320 32 32 32 32 1 
288 320 32 32 32 32 1 
256 320 32 32 32 32 1 
224 320 32 32 32 32 1 
192 320 32 32 32 32 1 
160 320 32 32 32 32 1 
128 320 32 32 32 32 1 
96 320 32 32 32 32 1 
64 320 32 32 32 32 1 
32 320 32 32 32 32 1 
576 288 32 32 0 64 1 
576 256 32 32 0 64 1 
576 224 32 32 0 64 1 
0 320 32 32 0 32 1 
0 384 32 32 0 64 1 
0 352 32 32 0 64 1 
0 416 32 32 0 96 1 
704 96 32 32 0 32 1 
736 96 32 32 32 32 1 
768 96 32 32 32 32 1 
544 288 32 32 0 0 1 
512 288 32 32 0 0 1 
480 288 32 32 0 0 1 
448 288 32 32 0 0 1 
416 288 32 32 0 0 1 
384 288 32 32 0 0 1 
352 288 32 32 0 0 1 
320 288 32 32 0 0 1 
288 288 32 32 0 0 1 
256 288 32 32 0 0 1 
224 288 32 32 0 0 1 
192 288 32 32 0 0 1 
160 288 32 32 0 0 1 
128 288 32 32 0 0 1 
96 288 32 32 0 0 1 
64 288 32 32 0 0 1 
32 288 32 32 0 0 1 
32 288 32 32 0 0 1 
0 288 32 32 0 0 1 
544 256 32 32 0 0 1 
512 224 32 32 0 0 1 
544 224 32 32 0 0 1 
512 256 32 32 0 0 1 
512 224 32 32 0 0 1 
544 192 32 32 0 0 1 
512 192 32 32 0 0 1 
