672 224 32 32 194.255 50757.3 1 
672 224 32 32 32 64 1 
704 224 32 32 32 64 1 
320 384 32 32 32 64 1 
256 384 32 32 32 64 1 
288 384 32 32 32 64 1 
224 384 32 32 32 64 1 
192 384 32 32 32 64 1 
384 192 32 32 32 64 1 
352 192 32 32 32 64 1 
320 192 32 32 32 64 1 
288 192 32 32 32 64 1 
224 192 32 32 32 64 1 
192 224 32 32 32 64 1 
192 224 32 32 32 64 1 
192 224 32 32 32 64 1 
192 224 32 32 32 64 1 
192 224 32 32 32 64 1 
192 224 32 32 32 64 1 
192 224 32 32 32 64 1 
256 224 32 32 32 64 1 
320 224 32 32 32 64 1 
384 192 32 32 32 64 1 
480 192 32 32 32 64 1 
576 160 32 32 32 64 1 
640 160 32 32 32 64 1 
672 160 32 32 32 64 1 
672 160 32 32 32 64 1 
672 160 32 32 32 64 1 
672 160 32 32 32 64 1 
672 160 32 32 32 64 1 
672 160 32 32 32 64 1 
672 160 32 32 32 64 1 
640 192 32 32 32 64 1 
608 256 32 32 32 64 1 
576 320 32 32 32 64 1 
512 352 32 32 32 64 1 
480 384 32 32 32 64 1 
480 416 32 32 32 64 1 
480 416 32 32 32 64 1 
480 416 32 32 32 64 1 
480 416 32 32 32 64 1 
512 352 32 32 32 64 1 
544 288 32 32 32 64 1 
608 224 32 32 32 64 1 
640 160 32 32 32 64 1 
672 128 32 32 32 64 1 
672 128 32 32 32 64 1 
672 128 32 32 32 64 1 
672 128 32 32 32 64 1 
640 128 32 32 32 64 1 
608 160 32 32 32 64 1 
512 224 32 32 32 64 1 
448 288 32 32 32 64 1 
416 320 32 32 32 64 1 
384 352 32 32 32 64 1 
384 384 32 32 32 64 1 
384 384 32 32 32 64 1 
384 352 32 32 32 64 1 
384 320 32 32 32 64 1 
448 288 32 32 32 64 1 
480 224 32 32 32 64 1 
512 192 32 32 32 64 1 
-nan -nan 32 32 32 64 1 
544 160 32 32 32 64 1 
544 160 32 32 32 64 1 
512 192 32 32 32 64 1 
448 256 32 32 32 64 1 
384 288 32 32 32 64 1 
352 352 32 32 32 64 1 
352 384 32 32 32 64 1 
352 384 32 32 32 64 1 
352 384 32 32 32 64 1 
416 352 32 32 32 64 1 
512 320 32 32 32 64 1 
608 256 32 32 32 64 1 
704 192 32 32 32 64 1 
704 192 32 32 32 64 1 
736 160 32 32 32 64 1 
768 160 32 32 32 64 1 
736 160 32 32 32 64 1 
736 160 32 32 32 64 1 
672 192 32 32 32 64 1 
576 224 32 32 32 64 1 
512 320 32 32 32 64 1 
448 384 32 32 32 64 1 
416 416 32 32 32 64 1 
416 448 32 32 32 64 1 
416 448 32 32 32 64 1 
448 448 32 32 32 64 1 
512 416 32 32 32 64 1 
608 352 32 32 32 64 1 
672 288 32 32 32 64 1 
736 224 32 32 32 64 1 
768 192 32 32 32 64 1 
768 192 32 32 32 64 1 
768 192 32 32 32 64 1 
736 192 32 32 32 64 1 
672 224 32 32 32 64 1 
576 256 32 32 32 64 1 
480 320 32 32 32 64 1 
416 352 32 32 32 64 1 
384 384 32 32 32 64 1 
384 384 32 32 32 64 1 
384 384 32 32 32 64 1 
416 352 32 32 32 64 1 
448 320 32 32 32 64 1 
512 288 32 32 32 64 1 
544 224 32 32 32 64 1 
576 192 32 32 32 64 1 
576 192 32 32 32 64 1 
