512 384 32 32 32 64 1 
544 384 32 32 194.255 50757.3 1 
544 384 32 32 32 64 1 
576 384 32 32 32 64 1 
608 384 32 32 32 64 1 
640 384 32 32 32 64 1 
