512 384 32 32 32 64 1 
544 384 32 32 194.255 50757.3 1 
544 384 32 32 32 64 1 
576 384 32 32 32 64 1 
608 384 32 32 32 64 1 
640 384 32 32 32 64 1 
640 352 32 32 194.255 50757.3 1 
640 352 32 32 194.255 50757.3 1 
640 352 32 32 194.255 50757.3 1 
640 352 32 32 32 64 1 
640 320 32 32 32 64 1 
640 288 32 32 32 64 1 
640 256 32 32 32 64 1 
640 224 32 32 32 64 1 
672 224 32 32 194.255 50757.3 1 
672 224 32 32 32 64 1 
704 224 32 32 32 64 1 
512 288 32 32 32 64 1 
480 288 32 32 32 64 1 
448 288 32 32 32 64 1 
